"filename", "language", "C#", "comment", "blank", "total"
"c:\Users\User\Documents\GitHub\UnityProjects\UnityProjects\Assets\Scripts\Chess\ChessGame.cs", "C#", 53, 0, 7, 60
"c:\Users\User\Documents\GitHub\UnityProjects\UnityProjects\Assets\Scripts\Chess\ChessGridManager.cs", "C#", 135, 5, 23, 163
"c:\Users\User\Documents\GitHub\UnityProjects\UnityProjects\Assets\Scripts\Chess\ChessMove.cs", "C#", 20, 0, 3, 23
"c:\Users\User\Documents\GitHub\UnityProjects\UnityProjects\Assets\Scripts\Chess\ChessMoveManager.cs", "C#", 208, 1, 26, 235
"c:\Users\User\Documents\GitHub\UnityProjects\UnityProjects\Assets\Scripts\Chess\ChessMoves.cs", "C#", 23, 0, 6, 29
"c:\Users\User\Documents\GitHub\UnityProjects\UnityProjects\Assets\Scripts\Chess\ChessOnClick.cs", "C#", 12, 1, 4, 17
"c:\Users\User\Documents\GitHub\UnityProjects\UnityProjects\Assets\Scripts\Chess\ChessStats.cs", "C#", 6, 0, 1, 7
"c:\Users\User\Documents\GitHub\UnityProjects\UnityProjects\Assets\Scripts\Data\SaveSystem.cs", "C#", 58, 2, 13, 73
"c:\Users\User\Documents\GitHub\UnityProjects\UnityProjects\Assets\Scripts\Data\SnakeData.cs", "C#", 30, 0, 4, 34
"c:\Users\User\Documents\GitHub\UnityProjects\UnityProjects\Assets\Scripts\Data\TicTacToeData.cs", "C#", 32, 0, 4, 36
"c:\Users\User\Documents\GitHub\UnityProjects\UnityProjects\Assets\Scripts\ErrorMessages.cs", "C#", 60, 0, 7, 67
"c:\Users\User\Documents\GitHub\UnityProjects\UnityProjects\Assets\Scripts\Menu\Buttons\BackButton.cs", "C#", 12, 0, 3, 15
"c:\Users\User\Documents\GitHub\UnityProjects\UnityProjects\Assets\Scripts\Menu\Buttons\Buttons.cs", "C#", 11, 0, 2, 13
"c:\Users\User\Documents\GitHub\UnityProjects\UnityProjects\Assets\Scripts\Menu\Buttons\SnakeLevelButton.cs", "C#", 45, 0, 4, 49
"c:\Users\User\Documents\GitHub\UnityProjects\UnityProjects\Assets\Scripts\Menu\Buttons\SnakePlayButton.cs", "C#", 20, 0, 4, 24
"c:\Users\User\Documents\GitHub\UnityProjects\UnityProjects\Assets\Scripts\Menu\Buttons\TicTacToeAIButton.cs", "C#", 45, 0, 3, 48
"c:\Users\User\Documents\GitHub\UnityProjects\UnityProjects\Assets\Scripts\Menu\Buttons\TicTacToeMaxPointsButton.cs", "C#", 31, 0, 4, 35
"c:\Users\User\Documents\GitHub\UnityProjects\UnityProjects\Assets\Scripts\Menu\Buttons\TicTacToePlayButton.cs", "C#", 12, 0, 4, 16
"c:\Users\User\Documents\GitHub\UnityProjects\UnityProjects\Assets\Scripts\Menu\MenuButtons.cs", "C#", 141, 10, 13, 164
"c:\Users\User\Documents\GitHub\UnityProjects\UnityProjects\Assets\Scripts\Menu\SceneData.cs", "C#", 4, 0, 1, 5
"c:\Users\User\Documents\GitHub\UnityProjects\UnityProjects\Assets\Scripts\Menu\SceneLoader.cs", "C#", 34, 0, 7, 41
"c:\Users\User\Documents\GitHub\UnityProjects\UnityProjects\Assets\Scripts\Menu\Score\Score.cs", "C#", 10, 0, 2, 12
"c:\Users\User\Documents\GitHub\UnityProjects\UnityProjects\Assets\Scripts\Menu\Score\SnakeScore.cs", "C#", 17, 0, 4, 21
"c:\Users\User\Documents\GitHub\UnityProjects\UnityProjects\Assets\Scripts\Menu\Score\TicTacToeScore.cs", "C#", 17, 0, 4, 21
"c:\Users\User\Documents\GitHub\UnityProjects\UnityProjects\Assets\Scripts\Pong\PongBallMovement.cs", "C#", 51, 2, 7, 60
"c:\Users\User\Documents\GitHub\UnityProjects\UnityProjects\Assets\Scripts\Pong\PongPlayerController.cs", "C#", 24, 0, 3, 27
"c:\Users\User\Documents\GitHub\UnityProjects\UnityProjects\Assets\Scripts\Pong\PongScoreManager.cs", "C#", 43, 3, 8, 54
"c:\Users\User\Documents\GitHub\UnityProjects\UnityProjects\Assets\Scripts\Snake\SnakeGame.cs", "C#", 63, 0, 11, 74
"c:\Users\User\Documents\GitHub\UnityProjects\UnityProjects\Assets\Scripts\Snake\SnakeGridManager.cs", "C#", 52, 0, 12, 64
"c:\Users\User\Documents\GitHub\UnityProjects\UnityProjects\Assets\Scripts\Snake\SnakePlayerController.cs", "C#", 206, 0, 26, 232
"c:\Users\User\Documents\GitHub\UnityProjects\UnityProjects\Assets\Scripts\Snake\SnakeStats.cs", "C#", 8, 0, 1, 9
"c:\Users\User\Documents\GitHub\UnityProjects\UnityProjects\Assets\Scripts\TicTacToe\TicTacToeAIs\TicTacToeAI.cs", "C#", 12, 0, 2, 14
"c:\Users\User\Documents\GitHub\UnityProjects\UnityProjects\Assets\Scripts\TicTacToe\TicTacToeAIs\TicTacToeAILevel1.cs", "C#", 15, 0, 2, 17
"c:\Users\User\Documents\GitHub\UnityProjects\UnityProjects\Assets\Scripts\TicTacToe\TicTacToeAIs\TicTacToeAILevel2.cs", "C#", 35, 0, 5, 40
"c:\Users\User\Documents\GitHub\UnityProjects\UnityProjects\Assets\Scripts\TicTacToe\TicTacToeAIs\TicTacToeAILevel3.cs", "C#", 58, 0, 9, 67
"c:\Users\User\Documents\GitHub\UnityProjects\UnityProjects\Assets\Scripts\TicTacToe\TicTacToeAIs\TicTacToeAILevel4.cs", "C#", 47, 0, 7, 54
"c:\Users\User\Documents\GitHub\UnityProjects\UnityProjects\Assets\Scripts\TicTacToe\TicTacToeButtonClick.cs", "C#", 36, 0, 5, 41
"c:\Users\User\Documents\GitHub\UnityProjects\UnityProjects\Assets\Scripts\TicTacToe\TicTacToeButtonManager.cs", "C#", 65, 1, 9, 75
"c:\Users\User\Documents\GitHub\UnityProjects\UnityProjects\Assets\Scripts\TicTacToe\TicTacToeGame.cs", "C#", 116, 8, 14, 138
"c:\Users\User\Documents\GitHub\UnityProjects\UnityProjects\Assets\Scripts\TicTacToe\TicTacToeGameController.cs", "C#", 59, 0, 11, 70
"c:\Users\User\Documents\GitHub\UnityProjects\UnityProjects\Assets\Scripts\TicTacToe\TicTacToeLineManager.cs", "C#", 67, 0, 14, 81
"c:\Users\User\Documents\GitHub\UnityProjects\UnityProjects\Assets\Scripts\TicTacToe\TicTacToePlayerToMove.cs", "C#", 25, 0, 4, 29
"c:\Users\User\Documents\GitHub\UnityProjects\UnityProjects\Assets\Scripts\TicTacToe\TicTacToeStats.cs", "C#", 8, 0, 0, 8
"Total", "-", 2026, 33, 303, 2362